XXXXXXXXXX
X X      X
X X    T X
XLX    XXX
X        X
X        X
XXXXXUXXXX